wwwwwwwwwwwww
wA.........gw
w....w......w
w.w.w..1....w
w+w....w....w
ww1..2..3...g
w..w..A.w.w.w
w...A.......w
wwwwwwwwwwwww
