wwwwwwwwwwwww
w......g...gw
w....w......w
w.w.w..1....w
w.w.........w
ww1..2..3..Aw
w..w..w.w.w3w
w...A.......w
wwwwwwwwwwwww
