w2.......w
w++++++++w
w++++++++w
w++++++++w
w++++++++w
w+++++A++w
w+b++++++w
w++++++++w
w++++++++w
w++++++++w
w.......1w
